0 0 -5 0 -5 5 0 5
0 1 -5 1 -5 5 1 -5
0 1 -5 1 5 5 1 5
0 2 -5 1 -4 -5 1 4
0 2 5 1 -4 5 1 5