#Starting room
0 0 -4 0 -4 4 0 4
4 1 5 0 -4 5 0 4
2 1 -4 0 5 4 0 5
8 1 -5 0 -4 -5 0 4
6 1 -4 0 -5 -2 0 -5
6 1 2 0 -5 4 0 -5


#First Hallway
0 0 -1 0 -16 1 0 -4
4 1 2 0 -12 2 0 -5
8 1 -2 0 -16 -2 0 -5


#Awful Hallway
0 0 -1 0 -16 54 0 -13
0 0 10 0 -26 14 0 -6
0 0 20 0 -26 24 0 -6
0 0 30 0 -26 34 0 -6
0 0 40 0 -26 44 0 -6
0 0 50 0 -26 54 0 -6

#Awful hallway walls
6 1 -1 0 -17 9 0 -17
6 1 15 0 -17 19 0 -17
6 1 25 0 -17 29 0 -17
6 1 35 0 -17 39 0 -17
6 1 45 0 -17 49 0 -17
2 1 2 0 -12 9 0 -12
2 1 15 0 -12 19 0 -12
2 1 25 0 -12 29 0 -12
2 1 35 0 -12 39 0 -12
2 1 45 0 -12 49 0 -12

#Awful Alley walls
8 1 9 0 -26 9 0 -17
6 1 10 0 -27 14 0 -27
4 1 15 0 -26 15 0 -17
8 1 9 0 -12 9 0 -6
2 1 10 0 -5 14 0 -5
4 1 15 0 -12 15 0 -6

8 1 19 0 -26 19 0 -17
6 1 20 0 -27 24 0 -27
4 1 25 0 -26 25 0 -17
8 1 19 0 -12 19 0 -6
2 1 20 0 -5 24 0 -5
4 1 25 0 -12 25 0 -6

8 1 29 0 -26 29 0 -17
6 1 30 0 -27 34 0 -27
4 1 35 0 -26 35 0 -17
8 1 29 0 -12 29 0 -6
2 1 30 0 -5 34 0 -5
4 1 35 0 -12 35 0 -6

8 1 39 0 -26 39 0 -17
6 1 40 0 -27 44 0 -27
4 1 45 0 -26 45 0 -17
8 1 39 0 -12 39 0 -6
2 1 40 0 -5 44 0 -5
4 1 45 0 -12 45 0 -6

8 1 49 0 -26 49 0 -17
8 1 49 0 -12 49 0 -6
2 1 50 0 -5 54 0 -5
4 1 55 0 -21 55 0 -6


#Third Hallway
0 0 50 0 -26 70 0 -22
6 1 50 0 -27 69 0 -27
2 1 55 0 -21 69 0 -21


#Boss Room
0 0 70 0 -36 120 0 -12
8 1 69 0 -36 69 0 -27
6 1 70 0 -37 120 0 -37 
4 1 121 0 -36 121 0 -27
4 1 121 0 -21 121 0 -12
2 1 70 0 -11 120 0 -11
8 1 69 0 -21 69 0 -12

#Boss Room Walls
3 1 73 0 -24 86 0 -24
1 1 89 0 -24 100 0 -24
3 1 103 0 -24 116 0 -24


#Last Hallway
0 0 120 0 -26 150 0 -22
0 0 148 0 -26 150 0 0
6 1 121 0 -27 150 0 -27
2 1 121 0 -21 147 0 -21
4 1 151 0 -26 151 0 -1
8 1 147 0 -21 147 0 -1


#Final Room
0 0 134 0 0 164 0 30
6 1 134 0 -1 147 0 -1
8 1 133 0 0 133 0 30
2 1 134 0 31 164 0 31
4 1 165 0 0 165 0 30
6 1 151 0 -1 164 0 -1

0 0 140 1 5 155 1 20
0 0 145 2 10 150 2 15

#Enemy
-1 71 -29
-1 118 -29
-1 118 -19
-1 71 -19